XXXXXXXXXX
Xp HXX mMX
X X XXtXeX
X X XX X X
X X XX X X
X XmXX X X
XPX XX X X
X XPXXPX X
X X XX XbX
X XpXX X X
X   tP XoX
X   XX X X
X    MRX X
X  XXXPX X
X  XX   PX
X  XXXXX X
Xo   TXX X
XXXXXXXXTX
XXXXXXXXXX
XXXXXXXXXX