XXXXXXXXXX
X M  H   X
Xb XXXXX X
X b   P  X
X  XX XX X
XMRXX XXpX
X  XXPXX X
X  XX  t X
XP     P X
X  XXXXX X
X XXXXXX X
X XT   otX
X XXXmXX X
X        X
X XXX XXXX
XpXXX XXXX
XPTXX XXXX
X XXXeXXXX
Xo      TX
XXXXXXXXXX