XXXXXXXXXX
XXXXXXXXHX
X   TMT oX
XtXXXXXXXX
XTXXXXXXXX
X XXXXXXXX
X      pmX
X  XXXXX X
X  XXXXX X
X       mX
XP XXXXX X
X  XXXXX X
X bXXXXX X
X RMT P oX
XbpXX    X
X  XX XX X
X t    P X
XP XX XX X
X    eT  X
XXXXXXXXXX