XXXXXXXXXX
X      H X
X        X
X        X
Xo       X
X        X
X        X
X   bb   X
X        X
X        X
X        X
X        X
X        X
X        X
X        X
X    e   X
X        X
X        X
X        X
XXXXXXXXXX
