XXXXXXXXXX
X  XX   XX
X  XPH   X
X P    o X
X       XX
X  XTXXXXX
X     XXXX
X   PpM XX
X b XXP  X
X  XXX   X
XX   M   X
XX  X   tX
XXX    XXX
X       XX
X    m   X
Xe  X    X
X     b TX
X  X t pbX
XR XX  TXX
XXXXXXXXXX