XXXXXXXXXX
XR      oX
X XTPX X X
X XXXX X X
X  XRM X X
XX X   X X
X PX X MRX
X TX  XXPX
X XXX XTPX
XeXm13XTTX
X1XXX1XXTX
X1X  11XPX
X1X X 1XPX
X1X Xb1XRX
X1X XX1XRX
X1X XP1X X
X1X   111X
X1XXXXXX1X
X11111111X
XXXXXXXXXX