XXXXXXXXXX
XR      oX
X XTPX X X
X XXXX X X
X  XRM X X
XX X   X X
X PX X MRX
X TX  XXPX
X XXX XTPX
XeXm 1XTTX
X XXX2XXTX
X X  1 XPX
X X X1 XPX
X X X23XRX
X X XX2XRX
X X XP1X X
X X   121X
X XXXXXX X
XR      oX
XXXXXXXXXX