XXXXXXXXXX
XR    11oX
X XTPX1X X
X XXXX1X X
X  X112X X
XX X1 1X X
X PX1X MRX
X TX11XXPX
X XXX1XTPX
XeXm 2XTTX
X XXX XXTX
X X    XPX
X X X  XPX
X X XbTXRX
X X XXTXRX
X X XPPX X
X X      X
X XXXXXX X
XR      oX
XXXXXXXXXX