XXXXXXXXXX
XR      oX
X XTPX X X
X XXXX X X
X  XRM X X
XX X1  X X
X PX3X MRX
X TX44XXPX
X XXX5XTPX
XeXm 2XTTX
X XXX XXTX
X X    XPX
X X X  XPX
X X XbTXRX
X X XXTXRX
X X XPPX X
X X      X
X XXXXXX X
XR      oX
XXXXXXXXXX