XXXXXXXXXX
X111111 oX
X1XTPX1X X
X1XXXX1X X
X11X111X X
XX1X1  X X
X 1X1X MRX
X11X11XXPX
X1XXX1XTPX
XeXm 1XTTX
X XXX XXTX
X X    XPX
X X X  XPX
X X XbTXRX
X X XXTXRX
X X XPPX X
X X      X
X XXXXXX X
XR      oX
XXXXXXXXXX