XXXXXXXXXX
XR      oX
X XTPX X X
X XXXX X X
X  XRM X X
XX X   X X
X PX X MRX
X TX  XXPX
X XXX XTPX
XeXm 1XTTX
X XXX2XXTX
X X 131XPX
X X X1 XPX
X X XbTXRX
X X XXTXRX
X X XPPX X
X X      X
X XXXXXX X
XR      oX
XXXXXXXXXX