XXXXXXXXXX
XR      oX
X XTPX X X
X XXXX X X
X  XRM X X
XX X   X X
X PX X MRX
X TX  XXPX
X XXX XTPX
XeXm 1XTTX
X1XXX2XXTX
X1X  11XPX
X1X X12XPX
X1X Xb1XRX
X1X XX1XRX
X1X X11X1X
X1X 34113X
X1XXXXXX3X
X11111123X
XXXXXXXXXX