XXXXXXXXXX
XR      oX
X XTPX X X
X XXXX X X
X  XRM X X
XX X   X X
X PX X MRX
X TX  XXPX
X XXX XTPX
XeXm 1XTTX
X XXX2XXTX
X X  11XPX
X X X 1XPX
X X Xb2XRX
X X XX2XRX
X X X11X X
X X  1   X
X XXXXXX X
XR      oX
XXXXXXXXXX