XXXXXXXXXX
XT TXm   X
X   XXX  X
X      H X
X   XX   X
XX XXXX XX
X TTXXPP X
X   XX   X
Xe       X
X o XX b X
XX XXXX XX
X   XX   X
X   XX   X
X      T X
X   XX   X
XX XXXX XX
X   XX   X
Xb bXXT TX
X M XXT TX
XXXXXXXXXX