XXXXXXXXXX
Xm    tTTX
XXXXX XXXX
XX T HT  X
XX XX XXoX
X   X X  X
X   X X  X
X  bX XT X
XX XX XXTX
X P X X  X
XX XX XTXX
X  pX X pX
X M X X TX
X   X X  X
XX XX XTXX
X R X X  X
X   X XXTX
X XXX X  X
X    e   X
XXXXXXXXXX