XXXXXXXXXX
X   bm   X
X XXXXXX X
XR      RX
XXXX  XXXX
X      M X
X M      X
X      M X
XXX    XXX
Xe      PX
X    H  PX
XXXXX XXXX
X     X TX
X XXXXX XX
X        X
XXXXXX XXX
XTTX   XTX
XTTXX XXTX
X    b   X
XXXXXXXXXX