XXXXXXXXXX
XMX e X TX
X        X
X   X   XX
X   p    X
XX  XX  bX
X P      X
X X X  X X
XT       X
X      o X
X  X   XPX
X    H   X
XX      XX
Xb      bX
X        X
X X p  X X
XP      PX
X    m   X
XT TXT TXX
XXXXXXXXXX