XXXXXXXXXX
XXXpm    X
XXXXXXXX X
X    b  HX
X XX XXXXX
X XX XXXXX
X MX XT tX
X XX XTX X
X XX XTX X
X MX XTX X
X XX XXX X
X P o  P X
X XXXXXX X
XTX RR XTX
X X    X X
X XX  XX X
X   TT   X
Xp   e   X
XXXXXXXXXX