XXXXXXXXXX
X   eXXXXX
X X    MMX
X X  X   X
X    X t X
X oXXXXX X
XX   X bPX
XX M X   X
XX  R   XX
X  X Xb XX
Xp X X  XX
X  X X  MX
Xb  P t  X
XbXXX t  X
X Xo TTXXX
X XXX P HX
XR pX  XXX
X XXX  b X
X TT R XXX
XXXXXXXXXX