XXXXXXXXXXXX
XXHXXXXXXXXX
XX  TT  PP X
XXX XXXX  XX
XXXo  XXRXXX
XTXXXM  MXXX
XXXXXXbbbXXX
Xp t    XXXX
XX XXXX    X
X R   m  R X
X XXXXXXXX X
X      Xp PX
XXXXX XXXXXX
XeXX bb    X
X XXXXXXXX X
X X     M  X
X X  X XXXXX
X XXTXXTXXTX
X    o   o X
XXXXXXXXXXXX