XXXXXXXXXXX
X  HXP  TTX
X XXX PX  X
X X X  X  X
X   R  X bX
X X       X
Xo  XM X  X
X   XXXX  X
X    TT   X
X XX   m  X
XmXR  XXX X
XtXX  bXP X
X XM  XXX X
X XX M    X
X bb  X XXX
X  X   R  X
X oXM XX  X
X XX   X PX
X eX TTXXPX
XXXXXXXXXXX