XXXXXXXXXX
X X XHX XX
X R      X
XXRX XtX X
X   M   tX
XmX X XMXX
X  bb M  X
XX X X X X
X TT     X
XXX X XpXX
X X XRX XX
X X X X XX
X        X
Xttt  tttX
XeX    MXX
X XXX XXXX
XR   M   X
XXXpXXXXRX
XXXXXXXXXX