XXXXXXXXX
XeXbb X X
X X   X X
X M X XoX
X X XRt X
X X X X X
X X m XTX
X X X XPX
X XMX X X
X R X   X
X X X X X
XoXRX X X
XTX   X X
XTX X XHX
XXXXXXXXX