XXXXXXXXXX
X beb  ttX
XPb bXT bX
XtXt  P tX
XXXXPXb tX
XbPXX PMXX
XXbTH tXXX
XTtMPtbtbX
XXXXXXXXXX