XXXXXXXXXX
XXXXHXXXXX
XXXX XXXXX
XXR   RXXX
XXXT TXXXX
XXR   RXXX
XXXX XXXXX
XXXXeXXXXX
XXXXXXXXXX