XXXXXXXXXX
XPpXTXTXXX
X X RXmXXX
XPM XX XXX
XXX    XXX
XXX    XTX
XXXeXX XTX
XXXXXM   X
XXXXXX XXX
XXXPXX XPX
XXXM   X X
XX       X
XX    oX X
XpR      X
XXXXXbXX X
XXTTXXX  X
Xb  t    X
XX TX   HX
XXbXXMXXXX
XXXXXXXXXX