XXXXXXXXXX
Xm  H  MTX
XXXXX  XXX
XR      PX
XM    XXTX
XXXXX XXXX
XP  M M  X
XXXX XXXXX
X  t    pX
X XX XXX X
X Xb b   X
X X XXXXXX
X        X
XXXXXXXX X
XM       X
X XX  XX X
X XX  XX X
X  M  M  X
Xp      eX
XXXXXXXXXX