XXXXXXXXXX
XXXXXXXXXX
XRTT  mXXX
Xttt   XXX
X       XX
X XX  X XX
X XP TXpXX
X eX XX XX
XXXXR   XX
XXXXTXX XX
XX pXXX XX
XM XXXP XX
XX  XXXRXX
XX    X XX
XT  R b oX
X XXTX X X
X XXPX XTX
X XXXX X X
Xb    P HX
XXXXXXXXXX