XXXXXXXXXX
Xm RX  beX
X X o X bX
X   X  X X
X XP MXP X
X  XT  X X
X X X  X X
X P XpX PX
X X  X  XX
X  XXX   X
X XTT X  X
X X X X  X
X oX MpX X
XT   XPR X
X X X  X X
X tMXX   X
X X XT X X
X    X  mX
XH X   X X
XXXXXXXXXX