XXXXXXXXXX
XmX HXMTRX
X X  XMTRX
X X  X X X
X XT   X X
X XXX    X
X XT     X
X        X
XXXXPPXXXX
XM      MX
X  XXXX  X
Xo XbTX  X
X        X
X   XX   X
XT  TP   X
X   TP   X
X        X
X        X
X  b  b eX
XXXXXXXXXX