XXXXXXXXXX
XR      oX
X XTPX X X
X XXXX X X
X  XRM X X
XX X   X X
X PX X MRX
X TX  XXPX
X XXX XTPX
XeXm HXTTX
X XXX XXTX
X X    XPX
X X X  XPX
X X XbTXRX
X X XXTXRX
X X XPPX X
X X      X
X XXXXXX X
XR      oX
XXXXXXXXXX