XXXXXXXXXXX
X  b  PM PX
X         X
X        RX
X   XXXX  X
X      X  X
XP T  HX PX
X   XXXX  X
X  T T    X
XP       RX
X  T      X
X  o   e  X
XP    mM PX
XXXXXXXXXXX