XXXXXXXXXX
XXXXXX  eX
XRTXXX XXX
X XX M   X
X X TX mPX
X    X XXX
XXX  XpXXX
Xp   XXXXX
X R  XXXXX
XTPX  XXXX
XXXXX XXXX
XTXXX PXXX
XTXX RXPXX
XM X  X XX
XX      bX
XXXXXXX XX
XXHXXXX bX
XT XXXX XX
XT     oXX
XXXXXXXXXX