XXXXXXXXXX
XXX  R   X
XXXRXP XpX
XXX PX XXX
XXX    XTX
XXXMXX t X
XXXTXP   X
XXX XX t X
XXm X  XTX
X   pXoXXX
X  TXX XXX
XRTXXX  TX
XeXXXX  XX
XXXXXX   X
XXXXXX XTX
XXXXXX XXX
XXXPRX XXX
XXXX X XXX
XXXb  H bX
XXXXXXXXXX