XXXXXXXXXX
XTTTX eXRX
XTTmX    X
XXX X    X
X   X    X
X   X    X
X  HX    X
XXX XX   X
Xb  TX   X
XX  bX   X
XP  TX   X
XP  XX   X
X        X
X        X
X        X
X        X
X        X
X        X
XM    MXRX
XXXXXXXXXX