XXXXXXXXXX
XXXXXXXXXX
XT XPXXXXX
X R  pXXXX
X  X XMXXX
XT      oX
XXXX XtX X
XeX    X X
X111  XX X
XXX1 XXPPX
XXX1XXXXXX
X11321X pX
XX XX  MXX
XX   bX XX
XXbXX  MTX
XXPXXXX XX
XXXXXXX XX
XTR  m  TX
XTX  PXXXX
XXXXXXXXXX