XXXXXXXXXX
XXXXXXXXXX
XT XPXXXXX
X R  pXXXX
X  X XMXXX
XT      oX
XXXX XtX X
XeX    X X
X111  XX X
XXX1 XXPPX
XXX1XXXXXX
X121  X pX
XX2XX  MXX
XX3  bX XX
XX1XX  MTX
XXPXXXX XX
XXXXXXX XX
XTR  m  TX
XTX  PXXXX
XXXXXXXXXX